{
  "name": "E59S42",
  "shard": "shard3",
  "rcl": 8,
  "buildings": {
    "container": {
      "pos": [
        { "x": 36, "y": 41 },
        { "x": 18, "y": 44 },
        { "x": 18, "y": 38 }
      ]
    },
    "constructedWall": {
      "pos": [
        { "x": 18, "y": 28 },
        { "x": 38, "y": 34 },
        { "x": 39, "y": 34 },
        { "x": 37, "y": 35 },
        { "x": 38, "y": 35 },
        { "x": 39, "y": 35 },
        { "x": 38, "y": 33 },
        { "x": 39, "y": 33 },
        { "x": 40, "y": 33 },
        { "x": 14, "y": 32 },
        { "x": 14, "y": 34 },
        { "x": 18, "y": 29 },
        { "x": 17, "y": 29 },
        { "x": 31, "y": 31 },
        { "x": 35, "y": 33 },
        { "x": 36, "y": 30 },
        { "x": 35, "y": 31 },
        { "x": 33, "y": 31 }
      ]
    },
    "road": {
      "pos": [
        { "x": 20, "y": 37 },
        { "x": 22, "y": 37 },
        { "x": 23, "y": 37 },
        { "x": 24, "y": 37 },
        { "x": 25, "y": 37 },
        { "x": 26, "y": 37 },
        { "x": 27, "y": 37 },
        { "x": 29, "y": 37 },
        { "x": 19, "y": 37 },
        { "x": 28, "y": 36 },
        { "x": 26, "y": 36 },
        { "x": 26, "y": 35 },
        { "x": 27, "y": 35 },
        { "x": 28, "y": 35 },
        { "x": 31, "y": 37 },
        { "x": 32, "y": 36 },
        { "x": 33, "y": 35 },
        { "x": 34, "y": 34 },
        { "x": 34, "y": 33 },
        { "x": 33, "y": 32 },
        { "x": 32, "y": 32 },
        { "x": 31, "y": 32 },
        { "x": 30, "y": 33 },
        { "x": 29, "y": 34 },
        { "x": 35, "y": 35 },
        { "x": 36, "y": 36 },
        { "x": 37, "y": 37 },
        { "x": 38, "y": 38 },
        { "x": 37, "y": 39 },
        { "x": 33, "y": 37 },
        { "x": 35, "y": 39 },
        { "x": 30, "y": 38 },
        { "x": 30, "y": 40 },
        { "x": 29, "y": 39 },
        { "x": 31, "y": 39 },
        { "x": 28, "y": 38 },
        { "x": 39, "y": 39 },
        { "x": 40, "y": 40 },
        { "x": 39, "y": 42 },
        { "x": 38, "y": 42 },
        { "x": 37, "y": 41 },
        { "x": 36, "y": 40 },
        { "x": 32, "y": 38 },
        { "x": 33, "y": 38 },
        { "x": 28, "y": 37 },
        { "x": 30, "y": 37 },
        { "x": 33, "y": 36 },
        { "x": 34, "y": 37 },
        { "x": 34, "y": 38 },
        { "x": 35, "y": 38 },
        { "x": 36, "y": 39 },
        { "x": 37, "y": 40 },
        { "x": 38, "y": 41 },
        { "x": 32, "y": 37 },
        { "x": 31, "y": 38 },
        { "x": 29, "y": 38 },
        { "x": 40, "y": 41 },
        { "x": 35, "y": 37 },
        { "x": 19, "y": 38 },
        { "x": 29, "y": 32 },
        { "x": 28, "y": 32 },
        { "x": 27, "y": 33 },
        { "x": 27, "y": 34 },
        { "x": 26, "y": 32 },
        { "x": 25, "y": 32 },
        { "x": 24, "y": 33 },
        { "x": 25, "y": 34 },
        { "x": 23, "y": 32 },
        { "x": 21, "y": 32 },
        { "x": 22, "y": 32 },
        { "x": 20, "y": 33 },
        { "x": 20, "y": 34 },
        { "x": 21, "y": 35 },
        { "x": 22, "y": 36 },
        { "x": 21, "y": 37 },
        { "x": 23, "y": 38 },
        { "x": 23, "y": 39 },
        { "x": 23, "y": 40 },
        { "x": 23, "y": 41 },
        { "x": 23, "y": 42 },
        { "x": 23, "y": 43 },
        { "x": 23, "y": 44 },
        { "x": 23, "y": 45 },
        { "x": 24, "y": 46 },
        { "x": 25, "y": 47 },
        { "x": 26, "y": 48 },
        { "x": 27, "y": 49 },
        { "x": 19, "y": 43 },
        { "x": 20, "y": 42 },
        { "x": 21, "y": 41 },
        { "x": 22, "y": 40 },
        { "x": 25, "y": 38 },
        { "x": 24, "y": 38 },
        { "x": 26, "y": 38 },
        { "x": 27, "y": 38 },
        { "x": 20, "y": 36 },
        { "x": 18, "y": 35 },
        { "x": 17, "y": 36 },
        { "x": 18, "y": 37 },
        { "x": 19, "y": 36 },
        { "x": 19, "y": 33 },
        { "x": 18, "y": 34 },
        { "x": 19, "y": 40 },
        { "x": 18, "y": 41 },
        { "x": 19, "y": 42 },
        { "x": 20, "y": 41 },
        { "x": 18, "y": 43 }
      ]
    },
    "spawn": {
      "pos": [
        { "x": 27, "y": 36 },
        { "x": 21, "y": 36 },
        { "x": 18, "y": 36 }
      ]
    },
    "storage": {
      "pos": [{ "x": 30, "y": 39 }]
    },
    "rampart": {
      "pos": [
        { "x": 19, "y": 28 },
        { "x": 14, "y": 33 },
        { "x": 32, "y": 30 },
        { "x": 36, "y": 32 },
        { "x": 33, "y": 30 },
        { "x": 34, "y": 30 },
        { "x": 13, "y": 32 },
        { "x": 13, "y": 33 },
        { "x": 13, "y": 34 },
        { "x": 19, "y": 29 },
        { "x": 22, "y": 28 },
        { "x": 22, "y": 29 },
        { "x": 23, "y": 28 },
        { "x": 23, "y": 29 },
        { "x": 32, "y": 31 },
        { "x": 34, "y": 31 },
        { "x": 35, "y": 32 },
        { "x": 35, "y": 30 },
        { "x": 36, "y": 31 }
      ]
    },
    "extension": {
      "pos": [
        { "x": 31, "y": 33 },
        { "x": 32, "y": 33 },
        { "x": 33, "y": 33 },
        { "x": 33, "y": 34 },
        { "x": 32, "y": 34 },
        { "x": 31, "y": 34 },
        { "x": 30, "y": 34 },
        { "x": 29, "y": 35 },
        { "x": 30, "y": 35 },
        { "x": 31, "y": 35 },
        { "x": 32, "y": 35 },
        { "x": 30, "y": 36 },
        { "x": 29, "y": 36 },
        { "x": 31, "y": 36 },
        { "x": 34, "y": 35 },
        { "x": 35, "y": 36 },
        { "x": 36, "y": 37 },
        { "x": 34, "y": 36 },
        { "x": 36, "y": 38 },
        { "x": 37, "y": 38 },
        { "x": 38, "y": 40 },
        { "x": 39, "y": 40 },
        { "x": 39, "y": 41 },
        { "x": 38, "y": 39 },
        { "x": 25, "y": 36 },
        { "x": 24, "y": 36 },
        { "x": 23, "y": 36 },
        { "x": 25, "y": 35 },
        { "x": 24, "y": 35 },
        { "x": 23, "y": 35 },
        { "x": 22, "y": 35 },
        { "x": 24, "y": 34 },
        { "x": 23, "y": 34 },
        { "x": 22, "y": 34 },
        { "x": 21, "y": 34 },
        { "x": 23, "y": 33 },
        { "x": 22, "y": 33 },
        { "x": 21, "y": 33 }
      ]
    },
    "tower": {
      "pos": [
        { "x": 32, "y": 39 },
        { "x": 27, "y": 32 },
        { "x": 22, "y": 38 }
      ]
    },
    "terminal": {
      "pos": [{ "x": 28, "y": 39 }]
    },
    "lab": {
      "pos": [
        { "x": 29, "y": 33 },
        { "x": 28, "y": 34 },
        { "x": 28, "y": 33 },
        { "x": 26, "y": 33 },
        { "x": 25, "y": 33 },
        { "x": 26, "y": 34 },
        { "x": 20, "y": 35 },
        { "x": 19, "y": 35 },
        { "x": 19, "y": 34 }
      ]
    },
    "extractor": {
      "pos": [{ "x": 18, "y": 45 }]
    },
    "powerSpawn": {
      "pos": [{ "x": 19, "y": 41 }]
    }
  }
}
